111100000000000000010000
111100000000000000010000
000000000000000000000000
000000000000000000000000
000000000000000000000000
000000000000000000000000
000000000000000000000000
000000000000000000000000
000000000000000000000000
011011100000000000000000
111111000000000000000000
110111000000000000000000
110111000000000000000000
111100000000000000000000
111100000000000000000000
000000000000000000000000
000000000000000000000000
